 23FB -  23FE N   1
 2500 -  257F A/N 1
 2580 -  259F A/N 1
 2630         N   2 emoji
 2665         A   2 emoji
 26A1         W   2 emoji
 276C -  2771 N   2 emoji
 2B58         A   1
 E000 -  E00A A   2
 E0A0 -  E0D4 A   1 powerline
 E200 -  E2A9 A   2
 E300 -  E3E3 A   2
 E5FA -  E6AC A   2
 E700 -  E7C5 A   2
 EA60 -  EBEB A   2
 F000 -  F2E0 A   2
 F300 -  F32F A   2
 F400 -  F532 A   2
F0001 - F1AF0 A   2
